A
Active-matrix | 主动矩阵
Adapter cards | 适配卡
Advanced application | 高级应用
Analytical graph | 分析图表
Analyze ['ænə,laɪz] | 分析
Animations | 动画
Application software | 应用软件
Arithmetic operations | 算术运算
Audio-output device | 音频输出设备
Access time | 存取时间
access | 存取
accuracy | 准确性
ad network cookies | 广告网络信息记录软件
administrator | 管理员
Add-ons | 插件
Address | 地址
Agents | 代理
Analog signals | 模拟信号
Applets | 程序
Asynchronous communications port | 异步通信端口
Attachment | 附件
AGP accelerated graphics port | 加速图形接口
ALU arithmetic-logic unit | 算术逻辑单元
B
Bar code | 条形码
Bar code reader | 条形码读卡器
Basic application | 基础程序
Binary coding schemes | 二进制编码方案
Binary system | 二进制系统
Bit | 比特
Browser | 浏览器
Bus line | 总线
Backup tape cartridge units | 备份磁带盒单元
Bandwidth | 带宽
Bluetooth | 蓝牙
Broadband | 宽带
Business-to-business | 企业对企业电子商务
Business-to-consumer | 企业对消费者
Bus总线
C
Cables | 连线
Cell | 单元箱
Chain printer | 链式打印机
Character and recognition device | 字符标识识别设备
Chart | 图表
Chassis | 支架
Chip | 芯片
Clarity | 清晰度
Closed architecture | 封闭式体系结构
Column | 列
Combination key | 结合键
computer competency | 计算机能力
connectivity | 连接，结点
Continuous-speech recognition system | 连续语言识别系统
Control unit | 操纵单元
Cordless or wireless mouse | 无线鼠标
Cable modems | 有线调制解调器
CD-ROM | 只读光盘
CD-RW | 可重写光盘
CD-R | 可记录压缩光盘
Channel | 信道
Chat group | 谈话群组
chlorofluorocarbons(CFCs) | 氯氟甲烷
Client | 客户端
Coaxial cable | 同轴电缆
cold site | 冷网站
Commerce servers | 商业服务器
Communication channel | 信道
Communication systems | 信息系统
CD（Compact disc） | 光盘
computer crime | 计算机犯罪
computer ethics | 计算机道德
Computer network | 计算机网络
computer support specialist | 计算机支持专家
computer technician | 计算机技术人员
computer trainer | 计算机教师
Connection device | 连接设备
Connectivity | 连接
Consumer-to-consumer | 个人对个人
cookies-cutter programs | 信息记录截取程序
cookies | 信息记录程序
cracker | 解密高手
Cyber cash | 电子货币
Cyberspace | 计算机空间
cynic | 愤世嫉俗者
chart | 图表
closed architecture  | 封闭式体系结构
CPU central processing  | unit中央处理器
CMOS complementary metal-oxide semiconductor | 互补金属氧化物半导体
CISC complex instruction set computer | 复杂指令集计算机
CRT cathode-ray tube | 阴极射线管
D
Database | 数据库
database files | 数据库文件
Database manager | 数据库管理
Data bus | 数据总线
Data projector | 数码放映机
Desktop system unit | 台式电脑系统单元
Destination file | 目标文件
Digital cameras | 数码照相机
Digital notebooks | 数字笔记本
Digital video camera | 数码摄影机
Discrete-speech recognition system | 不连续语言识别系统
Document | 文档
document files | 文档文件
Dot-matrix printer | 点矩阵式打印机
Dual-scan monitor | 双向扫描显示器
Dumb terminal | 非智能终端
data security | 数据安全
Data transmission specifications | 数据传输说明
database administrator | 数据库管理员
Data play | 数字播放器
Demodulation | 解调
denial of service attack | 拒绝服务攻击
Dial-up service | 拨号服务
Digital cash | 数字现金
Digital signals | 数字信号
Digital subscriber line | 数字用户线路
Digital versatile disc | 数字化通用磁盘
Digital video disc | 数字化视频光盘
Direct access | 直接存取
Directory search | 目录搜索
disaster recovery plan | 灾难恢复计划
Disk caching | 磁盘驱动器高速缓存
Diskette | 磁盘
Disk | 磁碟
Distributed data processing system | 分部数据处理系统
Distributed processing | 分布处理
Domain code | 域代码
Downloading | 下载
DVD（Digital Versatile Disc） | 数字多功能光盘
DVD-R  | 可写DVD
DVD-RAMDVD | 随机存取器
DVD-ROM | 只读DVD
DBMS （database management system） | 数据库管理系统
Domain name system（DNS） | 域名服务器
E
e-book | 电子阅读器
Expansion cards | 扩展卡
end user | 终端用户
e-cash | 电子现金
e-commerce | 电子商务
electronic cash | 电子现金
electronic commerce | 电子商务
encrypting | 加密术
energy star | 能源之星
Enterprise computing | 企业计算化
environment | 环境
Erasable optical disks | 可擦除式光盘
ergonomics | 人类工程学
ethics | 道德规范
External modem | 外置调制解调器
extranet | 企业外部网
F
Fax machine | 传真机
Field | 域
Find | 搜索
FireWire port | 火线端口
Firmware | 固件
Flash RAM | 闪存
Flatbed scanner | 台式扫描器
Flat-panel monitor | 纯平显示器
floppy disk | 软盘
Formatting toolbar | 格式化工具条
Formula | 公式
Function | 函数
Fiber-optic cable | 光纤电缆
File compression | 文件压缩
File decompression | 文件解压缩
filter | 过滤
firewall | 防火墙
firewall | 防火墙
Fixed disk | 固定硬盘
Flash memory | 闪存
Flexible disk | 可折叠磁盘
Floppies | 磁盘
Floppy-disk cartridge | 磁盘盒
Formatting | 格式化
frequency | 频率
frustrated | 受挫折
Full-duplex communication | 全双通通信
File transfer protocol(FTP) | 文件传送协议
G
General-purpose application | 通用运用程序
Gigahertz | 千兆赫
Graphic tablet | 绘图板
green pc | 绿色个人计算机
Group by  | 排序
H
handheld computer | 手提电脑
Hard copy | 硬拷贝
hard disk | 硬盘
hardware | 硬件
Help | 帮助
Host computer | 主机
Home page | 主页
Hyperlink | 超链接
hacker | 黑客
Half-duplex communication | 半双通通信
Hard-disk cartridge | 硬盘盒
Hard-disk pack | 硬盘组
Head crash | 磁头碰撞
header | 标题
help desk specialist | 帮助办公专家
helper applications | 帮助软件
Hierarchical network | 层次型网络
history file | 历史文件
hits | 匹配记录
horizontal portal | 横向用户
hot site | 热网站
Hybrid network | 混合网络
HTML（Hypertext Markup Language） | 超文本标示语言
HPSB high performance serial bus | 高性能串行总线
HDTV high-definition television | 高清晰度电视
I
Image capturing device | 图像获取设备
IT（information technology） | 信息技术
Ink-jet printer | 墨水喷射印刷机
Integrated package | 综合性组件
Intelligent terminal | 智能终端设备
Intergrated circuit | 集成电路
implements  | 实现接口
Interface cards | 接口卡
Internal modem | 内部调制解调器
internet telephony | 网络电话
internet terminal | 互联网终端
Identification识别
i-drive网络硬盘驱动器
illusion of anonymity | 匿名幻想
index search | 索引搜索
information pushers | 信息推送器
initializing  | 初始化
instant messaging | 计时信息
internal hard disk | 内置硬盘
Internet hard drive  | 网络硬盘驱动器
intranet | 企业内部网
ISA industry standard architecture | 工业标准结构体系
internet relay chat(IRC) | 互联网多线交谈
J
joystick | 操纵杆
K
keyword search | 关键字搜索
L
laser printer | 激光打印机
Layout files | 版式文件
Light pen | 光笔
Locate | 定位
Logical operations | 逻辑运算
Lands | 凸面
Line of sight communication | 视影通信
Low bandwidth | 低带宽
lurking | 潜伏
LCD liquid crystal display monitor | 液晶显示器
Local area network（LAN） | 局域网
M
Main board | 主板
Mark sensing | 标志检测
Mechanical mouse | 机械鼠标
Memory | 内存
Menu | 菜单
Menu bar | 菜单条
Microprocessor | 微处理器
Microseconds | 微秒
Modem card | 调制解调器
Monitor | 显示器
Motherboard | 主板
Mouse | 鼠标
Multifunctional device | 多功能设备
Magnetic tape reels | 磁带卷
Magnetic tape streamers | 磁带条
mailing list | 邮件列表
Medium band | 媒质带宽
metasearch engine | 整合搜索引擎
Microwave | 微波
Modem | 解调器
Modulation | 解调
Metropolitan area network(MAN) | 城域网
MICRmagnetic-ink character recognition | 磁墨水字符识别器
N
Net PC | 网络计算机
Network adapter card | 网卡
Network personal computer | 网络个人电脑
Network terminal | 网络终端
Notebook computer | 笔记本电脑
Notebook system unit | 笔记本系统单元
Numeric entry | 数字输入
national information infrastructure protection act of1996 | 国际信息保护法案
national service provider | 全国性服务供应商
Network architecture | 网络体系结构
Network bridge | 网桥
Network gateway | 网关
network manager | 网络管理员
newsgroup | 新闻组
no electronic theft act of1997 | 无电子盗窃法
Node | 节点
Nonvolatile storage | 非易失性存储
Network operation system(NOS) | 网络操作系统
O
Object embedding | 对象嵌入
Object linking | 目标链接
Open architecture | 开放式体系结构
Operation System | 操作系统
Optical disk | 光盘
Optical mouse | 光电鼠标
Optical scanner | 光电扫描仪
Outline | 大纲
off-line browsers | 离线浏览器
Online storage | 联机存储
OLE object linking and embedding | 对象链接入
OCR optical-character recognition | 光电字符识别器
OMR optical-mark recognition | 光标阅读器
P
palmtop computer | 掌上电脑
Parallel ports | 并行端口
Passive-matrix | 被动矩阵
PC card | 个人计算机卡
Personal laser printer | 个人激光打印机
Personal video recorder card | 个人视频记录卡
Photo printer | 照片打印机
Pixel | 像素
Platform scanner | 平版式扫描仪
Plotter | 绘图仪
Plug and play | 即插即用
Plug-in boards | 插件卡
Pointer | 指示器
Pointing stick | 指示棍
Port | 端口
Portable scanner | 便携式扫描仪
Presentation files | 演示文稿
Presentation graphics | 电子文稿程序
Primary storage | 主存
Procedures | 规程
Processor | 处理机
Programming control language | 程序控制语言
Packets | 数据包
Parallel data transmission | 平行数据传输
Peer-to-peer network system | 点对点网络系统
person-person auction site | 个人对个人拍卖站点
physical security | 物理安全
Pits | 凹面
plug-in | 插件程序
privacy | 隐私权
proactive | 主动地
programmer | 程序员
Protocols | 协议
provider | 供应商
project | 项目，工程
proxy server | 代理服务
pull products | 推取程序
push products | 推送程序
PDA（personal digital assistant） | 个人数字助理
PCI peripheral component interconnect | 外部设备互连总线
PCMCIA Personal Memory Card International Association | 个人计算机存储卡国际协会
R
RAM cache | 随机高速缓冲器
Range | 范围
Record | 记录
Relational database | 关系数据库
Replace | 替换
Resolution | 分辨率
Row | 行
Read-only | 只读
Reformatting | 重组
regional service provider | 区域性服务供应商
reverse directory | 反向目录
right to financial privacy act of 1979 | 财产隐私法案
Ring network | 环形网
RAM（random access memory） | 随机存储器
ROM read-only memory | 只读存储器
S
Scanner | 扫描器
Search | 查找
Secondary storage device | 辅助存储设备
Semiconductor | 半导体
Serial ports | 串行端口
Server | 服务器
Shared laser printer | 共享激光打印机
shakedown test | 调试
Sheet | 表格
Silicon chip | 硅片
Slots | 插槽
Smart card | 智能卡
Soft copy | 软拷贝
Software suite | 软件协议
Sorting | 排序
Source file | 源文件
Special-purpose application | 专用文件
Spreadsheet | 电子数据表
Standard toolbar | 标准工具栏
Supercomputer | 巨型机
System | 系统
Systemcabinet | 系统箱
System clock | 时钟
System software | 系统软件
Satellite/air connection services | 卫星无线连接服务
search engines | 搜索引擎
search providers | 搜索供应者
search services | 搜索服务器
Sectors | 扇区
security | 安全
Sending and receiving devices | 发送接收设备
Sequential access | 顺序存取
Serial data transmission | 单向通信
signature line | 签名档
snoopware | 监控软件
software copyright act of1980 | 软件版权法案
software piracy | 软件盗版
Solid-state storage | 固态存储器
specialized search engine | 专用搜索引擎
spiders | 网页爬虫
spike | 尖峰电压
Star network | 星型网
Strategy | 方案
subject | 主题
subscription address | 预定地址
Superdisk | 超级磁盘
surfing | 网上冲浪
surgeprotector | 浪涌保护器
systems analyst | 系统分析师...
SQL structured query language | 结构化查询语言
T
Table | 二维表
Telephony | 电话学
Television boards | 电视扩展卡
Terminal | 终端
Template | 模板
Text entry | 文本输入
Thermal printer | 热印刷
Thin client | 瘦客
Toggle key | 触发键
Toolbar | 工具栏
Touch screen | 触摸屏
Trackball | 追踪球
TV tuner card | 电视调谐卡
Two-state system | 双状态系统
technical writer | 技术协作者
technostress | 重压技术
telnet | 远程登录
Time-sharing system | 分时系统
Topology | 拓扑结构
Tracks | 磁道
traditional cookies | 传统的信息记录程序
Twisted pair | 双绞
TFT thin film transistor monitor | 薄膜晶体管显示器
U
Unicode | 统一字符标准
uploading | 上传
usenet | 世界性新闻组网络
URL uniform resource locator | 统一资源定位器
USB universal serial bus | 通用串行总线
V
Virtual memory | 虚拟内存
Video display screen | 视频显示屏
Voice recognition system | 声音识别系统
vertical portal | 纵向门户
video privacy protection act of 1988 | 视频隐私权保护法案
virus checker | 病毒检测程序
virus | 病毒
Voiceband | 音频带宽
Volatile storage | 易失性存储
voltage surge | 电涌
W
Wand reader | 条形码读入
Web | 网络
Web appliance | 环球网设备
Web page | 网页
Web site address | 网络地址
Web terminal | 环球网终端
Webcam | 摄像头
What-if analysis | 假定分析
Wireless revolution | 无线革命
Word | 字长
Word processing | 文字处理
Word wrap | 自动换行
Worksheet file | 工作文件
web auctions | 网上拍卖
web broadcasters | 网络广播
web portals | 门户网站
web sites | 网站
web storefront creation packages | 网上商店创建包
web storefronts | 网上商店
web utilities | 网上应用程序
web-downloading utilities | 网页下载应用程序
webmaster web | 站点管理员
web | 万维网
Wireless modems | 无线调制解调器
wireless service provider | 无线服务供应商
WWW（world wide web） | 万维网
worm | 蠕虫病毒
Write-protect notch | 写保护口
Wide area network(WAN) | 广域网
Web server | 服务器
well-connected | 连接良好
well-known services | 公认的服务
wide area network, WAN | 广域网
wildcard character | 通配符
wildcarding | 通配符方式
window menu | 窗口菜单
Task Manager | 任务管理器
Management Instrumentation | 管理规范
Services | 服务
Windows Internet Name Service | 命名服务
proxy | 代理
resource | 资源
Winsock
wireless communication | 无线通讯
Management Instrumentation | 管理规范
workgroup | 工作组
X
certificate | 证书
XOR, exclusive OR | 异或
Z
zone | 区域
zone list | 区域列表
zone transfer | 区域传送
Zip disk | 压缩磁盘
